21
11
WWWWWWWWWWWWWWWWWWWWW
WGGGGGGGGGGGGGGGGGGGW
WGGGGWWWWWWWWWWWWWWWW
WVVVVGRGGGGGGGGRGGGGW
WGGVVRGGGGGGGGGGVGGGW
WGGGVVBGGRGGGGGVBVGGW
WGGVVGGGGGGGDGGGGVGGW
WGGRGGGGGGGGGGGGGGGGW
WGGGGGGGVVGGGGGGDGGEW
WRRGVGGGVBGGGGGGGGGGW
WWWWWWWWWWWWWWWWWWWWW
